#####################################
#                 #                 #
# ############# ##### ############# #
#             #       #             #
######### ### #### #### ### #########
#         #               #         #
#### #### # # # ## ## # # # #### ####
#      #    #   #   #   #    #      #
# #### ###### #   @   # ###### #### #
#      #    #   #   #   #    #      #
#### #### # # # ## ## # # # #### ####
#         #               #         #
######### ### #### #### ### #########
#             #       #             #
# ############# ##### ############# #
#                 #                 #
#####################################
